0,0,0,0,0,0,0,0,
0,1,1,2,3,5,6,4,
0,4,4,5,4,5,2,0,
0,1,1,2,3,4,2,3,
0,0,0,0,0,0,0,0,
#
0,0,0,0,0,0,0,0
0,1,1,1,1,1,1,0
0,1,3,0,4,0,1,0
0,1,1,1,1,1,1,0
0,0,0,0,0,0,0,0
#
