0,0,0,0,0,0,0,0,
8,1,3,1,1,3,4,0,
0,5,1,1,3,0,0,0,
0,1,6,1,3,7,2,0,
0,0,0,0,0,0,0,0,
#
0,0,0,0,0,0,0,0,0,0,0,
8,5,6,1,3,1,3,0,3,4,0,
0,1,1,5,4,1,3,6,1,3,0,
0,1,3,1,3,1,3,0,0,0,0,
0,1,3,1,3,1,3,1,7,2,0,
0,0,0,0,0,0,0,0,0,0,0,
#
0,0,0,0,0,0,0,0
8,1,1,3,1,0,2,0
0,1,3,0,3,0,7,0
0,6,3,1,3,1,3,0
0,0,0,0,0,0,0,0
#
