0,0,0,0,0,0,0,0,
8,1,1,6,3,1,6,0,0,0,
0,4,1,5,4,5,1,1,7,2,0,
0,1,1,1,3,4,3,0,0,0,
0,0,0,0,0,0,0,0,
#
0,0,0,0,0,0,0,0,
8,1,1,6,3,1,6,0,0,0,
0,4,1,5,4,5,3,3,7,2,0,
0,1,1,1,3,4,3,0,0,0,
0,0,0,0,0,0,0,0,
#
0,0,0,0,0,0,0,0
0,1,1,1,1,1,1,0
0,1,3,0,4,0,1,0
0,1,1,1,1,1,1,0
0,0,0,0,0,0,0,0
#
